000000000000000000000000000000000000000000000000
000000000000011111111000000000000000000000000000
000001111111111111111000000000000000000000000000
000001000000011111111001111111110000000000000000
000001000000011111111001000000010000000000000000
000001000000011111111001000000010000000000000000
000001000000011111111001000000010000000000000000
000001000000011111111001000000010000000000000000
000001000000011111111001000000010000000000000000
000001111000011111111001000000010000000000000000
000000001000011111111111000000010000000000000000
000000001000011111111000000000010000000000000000
000000001000000000000000001111111110000000000000
000000001000000000000000001111111110000000000000
000000111111110000000000001111111110000000000000
000000111111110000000000001111121110000000000000
000000111111110000000000001111111110000000000000
000000111111110000000000000000000000000000000000
000000000000000000000000000000000000000000000000
000000000000000000000000000000000000000000000000
000000000000000000000000000000000000000000000000
000000000000000000000000000000000000000000000000
000000000000000000000000000000000000000000000000
000000000000000000000000000000000000000000000000
000000000000000000000000000000000000000000000000