000000000000000000000000000000000000000000000000
011111111000000000000000000000000000000000000000
011111111000000000000000000000000000000000000000
011111111000000000000111000000000011111111111000
011111111111111111111111000000000012111111111000
011111111000000010000111000000000011111111111000
011111111000000010000000000000000011111111111000
011111111000000010000000000000000011111111111000
011111111000000010000000000000000011111111111000
011111111000000010000000000000000011111111111000
011111111000000010000001111110000011111111111000
011111111000000010000001111110000000000000100000
000000000000000010000001111110000000000000100000
000000000000000010000001111110000000000000100000
000000000000000010000001111110000000000000100000
000000000011111111111111111110000000000000100000
000000000000000010000001111110000000000000100000
000000000000000010000001111110000000000000100000
000000000000000010000000001000000000000000100000
000000000000111111100000001000000000000000100000
000000000000111111100000001000000000000000100000
000000000000111111100000001111111111111111100000
000000000000111111100000000000000000000000000000
000000000000000000000000000000000000000000000000
000000000000000000000000000000000000000000000000
